11111111
10000001
10000001
100P0E01
100C0011
11111111