11111111
10000001
10001001
10C00E01
10P01011
11111111