NO ./texture/mur1.xpm
SO ./texture/mur2.xpm
WE ./texture/mur3.xpm
EA ./texture/mur4.xpm
F 300,200,50
C 255,255,255

111111111
100000001
10N000001
100000001
111111111
