111111111111111111111111111111111111111111111111111111111
100000000000000000000000000000000000000000000000000000001
100000000000000000000000000000000000000000000000000000001
100000000000000000000000000000000000000000000000000000001
100000000000000000000000000000000000000000000000000000001
100000000000000000000000000100001000000000000000000000001
10000000000000000000000000010000C100000000000000000000001
100000000000000000000000000000001000000000000000000000001
100000000000000000000000000000000000000000000000000000001
111111111111111111111111111101111111111111111111111111111
100000000000000000000000000000000000000000000000000000001
100000000000000000000000000000000000000000000000000000001
100000000000000000000000000000000000001000000010000000001
10000000000000000000000000P00000000001C1000000E1000000001
100000000000000000000000000000000000001000000010000000001
111111111111111111111111111111111111111111111111111111111