111111111111111111111111111111111111111111111111111111111
10000000C000000000000000000000000000000000000000000000001
10000P00C000000000000000000000000000000000000000000000001
100000000000000000000000000000000000000000000000000000001
100000000000000000000000000000000000000000000000000000001
100000000000000000000000000000000000000000000000000000001
100000000000000000000000000000000000000000000000000000001
100000000000000000000000000000000000000000000000000000001
100000000000000000000000000000000000000000000000000000001
100000000000000000000000000000000000000000000000000000001
100000000000000000000000000000000000000000000000000000001
100000000000000000000000000000000000000000000000000000001
100000000000000000000000000000000000000000000000000000001
100000000000000000000000000000000000000000000000000000001
100000000000000000000000000000000000000000000000000000001
100000000000000000000000000000000000000000000000000000001
100000000000000000000000000000000000000000000000000000001
100000000000000000000000000000000000000000000000000000001
100000000000000000000000000000000000E00000000000000000001
100000000000000000000000000000000000000000000000000000001
100000000000000000000000000000000000000000000000000000001
100000000000000000000000000000000000000000000000000000001
100000000000000000000000000000000000000000000000000000001
100000000000000000000000000000000000000000000000000000001
111111111111111111111111111111111111111111111111111111111