11111111111
1000E000C01
10000P00C01
11111111111