1111111
1P00CC1
1111111
100E001
1111111